F 220,100,0
C 225,30,0
NO            	./src/assets/wolf/bluestone.png
SO    	./src/assets/wolf/colorstone.png
WE ./src/assets/wolf/mossy.png
EA  ./src/assets/wolf/greystone.png

111111111111111111111
1W0000000000000000001
111111110001111111111
       1000000001
        111111111