F 220,100,0
C 225,30,0
NO            	./src/assets/wolf/bluestone.png
SO    	./src/assets/wolf/colorstone.png
WE ./src/assets/wolf/mossy.png
EA  ./src/assets/wolf/greystone.png


0
1111
1E01
1111