NO            	./src/assets/wolf/bluestone.png
SO    	./src/assets/wolf/colorstone.png
EA  ./src/assets/wolf/greystone.png
WE ./src/assets/wolf/mossy.png
F 245,40,           145
C 56,56,      255
                              11111111
                        11111100000000111111
                    1111000000000000000100001111
                111100000000000000000001000000001111
              1100000000000000000000000100000000000011
            11111111110000000000000000010000000000000011
          110000000000000000000000000001000000000000000011
        1100000000000000000000000000000100000000000000000011
        1100000000000000000000000000000100000000000000000011
      11000000000000000000000000000000011111111110000000000011
      11000000000000000000000W00000000000000000000000000000011
    110000000000000000000000000000000000000000000000000000000011
    110000000000000000000000000000000000000000000000000000000011
    110000000000000000000000000000000000000000000000000000000011
  1100000000000000000000000000000000000000000000000000000000000011
1111000000000000000000000000000000000000000000000000000000000000111
    111111111111111111111100000000111111111111111111111111111111111
                    1111000000000000000000001111
                111100000000000000000000000000001111
              1100000000000000000000000000000000000011
            11000000000000000000000000000000000000001011
          110010000000000000000000000000000000000001000011
        1100000100000000000000000000000000000000001000000011
        1100000010000000000000000100000000000000010000000011
      11000000000100000000000000010000000000000010000000000011
      11000000000010000000000000010000000000000100000000000011
    110000000000000100000000000001000000000000100000000000000011
    110000000000000010000000000001000000000001000000000000000011
    110000000000000001000000000001000000000000000000000000000011
  1100000000000000000010000000000100000000000000000000000000000011
1111000000000000000000010000000101000000000000000000000000000000111
1111000000000000000000001000000000000000000000000000000000000000111
1111000000000000000000000100000000000000000000000000000000000000111
    110000000000000000000010000000000000000000000000000000000011
    110000000000000000000001000000000000000000000000000000000011
    110000000000000000000000100000000000000000000000000000000011
      11000000000000000000000000000000000000000000000000000011
      11000000000000000000000000000000000000000000000000000011
        1100000000000000000000000000000000000000000000000011
        1100000000000000000000000000000000000000000000000011
          110000000000000000000000000000000000000000000011
            11000000000000000000000000000000000000000011
              1100000000000000001000000000000000000011
                111100000000000010000000000000001111
                    1111000000001000000000001111
                        11111100100000111111
    1111111111111111111111110000100000011111111111111111111111111
1111000000000000000000000000000010000000000000000000000000000000111
1111000000000000000000000000000010000000000000000000000000000000111
    110000000000000000000000000010000000000000000000000000000011
    110000000000000000000000000010000000000000000000000000000011
    110000000000000000000000000010000000000000000000000000000011
      11000000000000000000000000100000000000000000000000000011
      11000000000000000000000000100000000000000000000000000011
        1100000000000000000000001000000000000000000000000011
        1100000000000000000000001000000000000000000000000011
          110000000000000000000010000000000000000000000011
            11000000000000000000100000000000000000000011
              1100000000000000001000000000000000000011
                111100000000000010000000000000001111
                    1111000000001000000000001111
                        11111100100000111111
                              11111111