NO ./textures/greystone.xpm
SO ./textures/greystone.xpm
WE ./textures/greystone.xpm
EA ./textures/greystone.xpm

F 245,40,145
C 56,56,255
111111
100001
100001
100001
100001
100001
100001
100S01
100001
111111