WE image/wall_texture.png

SO image/hbenouka.png

NO image/zaid.png

EA image/zaid.png

C 233,255,151

F 193,53,69

            11111111111111111111111111111111111111111111111111111111111111111111111111
            11000001111111111111111111111111111111111111111111111111111111111111111111
            10000000000000000000000000000000000000000000000000000000001111111111111111
            11000001100000000000000000000000000000000000000000000000001111111111111111
11111111111110000000000000000000000000000000000000000000001111111111111111
11010011100000000000000000000000000000000000000000000000001111111111111111
11000000000000000000000000000000000000000000000000000000001111111111111111
10000000000000000000011111111111111111111111111100000000011111111111111111
100000000000000000000001N0000000000000000000000000000000011111100000000111
10000000000000000000011111111111111111111111111100000000011111100000000111
10000000000000000000000000000000000000000000000000000000011111100000000111
10000000000000000000000000000000000000000000000000000000011111100000000111
10000000000000000000000000000000000000000000000000000000011111100000000111
10000000000000000000000000000000000000000000000000000000011111100000000111
10000000000000000000000000000000000000000000000000000000011111100000000111
10000000000000000000000000000000000000000000000000000000011111111111111111
10000000000000000000000000000000000000000000000000000000011111111111111111
10000000000000000000000000000000000000000000000000000000011111111111111111
11111111111111111111111111111111111111111111111111111111111111111111111111