123456789
1000001
100001
100001
11111111
