
NO ./textures/greystone.xpm


SO ./textures/greystone.xpm
WE ./textures/greystone.xpm


EA ./textures/greystone.xpm


F 112,112,112
C 56,56,56





1111111111111
1000001    1
100N01      1
100001      1
11111111    1
