
NO ./src/textures/wolf/greystone.png


SO ./src/textures/wolf/greystone.png
WE ./src/textures/wolf/greystone.png


EA ./src/textures/wolf/greystone.png


F 112,112,112
C 56,56,56





1111111111111
1000001    1    111
100N01      1   101
100001      1    1
11111111    1




1